 + - + - + - + - + - + - + - + - + - + - + - + - + - + - + - + - + - + - + - + - + - + - + - + - + - +
                 |   |                   |               |                                           |
 +   + - +   + - +   +   + - +   + - +   +   + - + - +   +   + - +   + - + - + - +   + - +   + - +   +
 |                                       |           |   |                       |       |       |   |
 +   +   + - +   + - +   +   + - +   +   +   + - +   +   +   +   +   +   + - +   + - +   +   +   +   +
 |   |   |   |           |   |   |   |                   |   |   |   |       |               |       |
 +   +   +   +   + - +   +   +   +   +   + - +   +   + - +   +   +   + - +   +   +   + - + - + - +   +
 |               |                               |           |           |       |       |   |       |
 +   + - +   +   +   + - +   + - + - +   + - +   +   +   +   + - +   +   +   +   +   +   +   +   +   +
 |   |   |   |       |   |   |                       |   |   |       |       |       |           |   |
 +   +   +   +   +   +   +   +   + - +   +   + - +   +   +   +   +   +   + - +   + - +   + - +   +   +
 |               |               |       |                       |           |                       |
 + - +   + - +   +   +   + - +   +   +   +   +   + - +   + - +   + - +   +   +   + - + - + - +   +   +
 |               |   |               |       |                       |   |   |   |               |   |
 + - + - + - +   +   +   + - +   +   +   + - +   + - +   + - + - +   +   +   +   + - +   + - +   +   +
 |               |   |   |       |       |           |                   |                           |
 + - + - +   + - +   +   +   + - +   + - +   +   +   +   + - + - +   +   + - +   + - + - +   + - +   +
 |                                       |   |   |                   |   |       |           |       |
 +   +   + - +   + - +   + - +   + - +   +   +   +   +   + - +   +   +   +   +   + - +   +   +   + - +
 |   |   |       |                   |               |       |   |       |   |           |       |   |
 + - +   + - +   +   +   +   +   +   +   + - +   +   + - +   +   + - +   +   +   + - +   + - +   +   +
 |                   |   |   |   |   |   |       |               |                                   |
 +   +   + - + - +   +   +   +   +   +   + - +   +   +   +   +   +   + - + - +   +   + - + - +   +   +
 |   |       |       |                   |           |   |   |   |           |   |               |   |
 +   + - +   +   +   +   +   + - +   +   +   + - +   +   +   +   +   + - +   +   +   + - + - +   +   +
 |       |       |   |   |   |       |                   |   |       |           |           |       |
 + - +   +   + - +   +   +   +   +   + - +   + - + - +   +   +   +   + - + - +   + - +   +   +   +   +
 |       |                       |           |           |       |                       |       |   |
 + - +   +   + - +   +   +   + - +   + - +   +   + - +   +   + - +   +   + - +   + - +   +   +   +   +
 |                   |   |                   |                   |   |   |   |       |       |       |
 + - + - +   + - +   +   + - + - +   + - +   +   + - +   + - +   +   +   +   +   +   +   +   + - +   +
 |                                                   |   |   |   |       |   |   |       |           |
 +   +   +   + - +   +   +   + - +   + - +   +   +   +   +   +   +   +   +   +   +   + - + - +   +   +
 |   |   |   |       |   |   |               |   |                   |                       |   |   |
 +   +   +   + - +   +   +   +   +   +   +   +   +   + - + - +   + - +   +   +   +   + - +   +   +   +
 |       |   |           |   |   |   |   |                           |   |   |   |               |   |
 + - +   +   + - +   +   +   +   +   +   +   + - + - +   + - + - +   +   +   +   +   + - + - +   +   +
 |                   |               |       |           |               |   |       |       |       |
 + - +   + - +   +   + - + - +   +   +   +   + - + - +   +   +   + - +   +   +   + - +   +   +   +   +
 |   |   |   |   |   |           |       |               |   |   |                       |       |   |
 +   +   +   +   +   +   + - +   + - +   + - +   + - +   +   +   +   +   + - +   + - +   +   +   +   +
 |                   |                           |       |   |       |   |   |   |       |   |       |
 +   + - + - + - +   +   + - +   + - +   + - +   + - +   +   +   + - +   +   +   +   +   +   + - +   +
 |   |                   |       |   |       |                                       |               |
 +   +   + - +   +   +   + - +   +   +   +   +   +   +   + - +   +   + - +   + - +   +   + - +   + - +
 |       |       |   |           |       |   |   |   |   |       |                           |       |
 + - +   +   + - +   + - + - +   +   + - +   +   +   +   +   +   +   + - +   +   +   + - +   + - +   +
 |                               |                       |   |               |   |                   |
 +   +   + - +   + - +   + - +   + - + - +   +   + - +   +   + - +   + - +   +   +   +   + - + - +   +
 |   |       |       |                       |       |               |       |       |           |    
 + - + - + - + - + - + - + - + - + - + - + - + - + - + - + - + - + - + - + - + - + - + - + - + - + - +

